R 200 299
NO ./textures/summer.xpm
SO ./textures/winter.xpm
WE ./textures/spring.xpm
EA ./textures/autumn.xpm

S ./textures/oldcry.xpm
F 100,150,255
C 200,21,1

11111111
10000001111111111111
100N000111111
1000000111111111111111
1111111111111111
111111
111111111
11111111222222223
