R 200 299
NO ./textures/summer.xpm
SO ./textures/winter.xpm
WE ./textures/spring.xpm
EA ./textures/autumn.xpm

S ./textures/oldcry.xpm
F 100,150,255
C 200,21,1

11111111
100000000
100N0001
10000001
11111111
